
breed - порода
stiff - жесткий, ноющий, густой, твёрдый
fines - штрафы
penalties - взыскания
solicit - подстрекать
conduct due diligence - проявлять должную предусмотрительность
courtesies - любезности
gratuities - чаевые
occasionally - иногда
allign - выстравиваются
overarching - всеобъемлющий
obliquity - отклонение
stove-piped - мало информации о контексте сведений
daunting - сложная
holds the promise - обещает
Conjure up - вызывать в воображении
streamline - рационализировать
beholden - обязанный
tremendous - огромный
like-minded - одинаково мыслящий

ditch - канава
procrastinating - проволочки
cadence - ритм

predicament - затруднение
dismissive - пренебрежительный 
condescending - снисходительный 
vindication - обоснование 
regular- систематический
redherring - отвлекающий маневр 
offend - обидеть 
dreaded - устрашиющий
apprehensive - настроженный 
counsel - советник 
allocating - выделение
rebates - скидки 
inferred - вывод 
deceptive - обманных 
mutual funds - паевые инвестиционные фонды 
malleable - поддатливый, ковкий 
dampen the whim - тушить прихоти 
nexorably - неумолимо
concomitant - сопутствующий 
furnish - представлять 
minutiae - мелочи 
thrust - упор
decay of grasp - распад понимания 
disseminates - распространяет
sentinel - часовой 
recurrence - повторение 
inteliggible - понятный
inflection - форма слова
stain - пятно 
envision - представлять себе
snappy - живой 
roundup - сводка новостей 
fence- преграда 
crippling - калечащий, критический 
bloating - встучивающие 
hop - танцульки
mitigation - смягчение, уменьшение 
relinquishes - отказываться 
lock - блокировка 
wreak havoc - сеять опустошение 
feature-rich - многофунциональный 
enlistment - вступление 
marshal - размещать
deficient - недостаточный 
bout - схватка 
grappled - сцепился
centennial - столетний 
quintuple - пятикратный 
convoluted - запутанный
haphazardly - случайно 
immerse - погружать 
jam - толчея 
broth - бульён
lever - рычаг 
*contagion *- зараза 
sprawl - разрастание 
tipping - опрокидывающийся 
riot - бунты 
uprising - восстание 
peruse - ознакомиться 
smuggled - контрабандный 
pitfalls - ловушки 
afflict - поражают 
languish - томиться 
lockups - зависания 
dissent - особое мнение, несогласие 
litter - замусорили 
lament - сетовать, жаловаться
lame - хромой
stark - застывший 
filthy - грязный 
terminal - конечные 
overhaul - пересмотр, ревизия 
Contagion - зараза 
wag - вилять 
topple - свержение
keen of - увлекаться 
reimbursements - возмещение 
fringe - бахрома
slipperiness - скользкость 
*profound - глубокий, основательный,значительный *
solicited - запрос 
evoke - вызыать
cumbersome - громоздкий 
fiddling - пуcтячный, ничтожный 
*crutch* -опора 
basemetn - подвал 
patties - пирожки 
flight attendant - борт проводник 
contingency - случайность, обстоятельства 
curtailed - ограниченный 
adverse - неблагоприятный 
gratification - удоволетворение
mean - средний, убогий, плохой 
grim - непреклонный 
oatmeal - овсяный
germ - зачаток 
walnut - грецкий орех 
disruptive - разрушительный
unrelentingly - неумолимо 
cuff - манжета 
efficient - действенный, продуктивный, производительный 
mulls - обдумывает 
stance - позиция, стойка 
strawberry - земляника 
pear - груша 
equestrian - конный 
assets - активы, средства, имущество 
hedgehog - еж 
hedge - преграда 
hog - свинья, боров 
innate - врожденный 
intercept - цена деления, перехват, отрезок 
creep up - подкрадываться 
diminishing - уменьшающийся 
lanes - полосы 
bran - отруби
pretzels - крендели
wage - заработная плата
payroll tax - налог на заработную плату 
broker - посредник 
proverbial - пресловутый 
straw - соломинка 
kink - излом 
slope - наклон, градиент
percolation - просачивание, фильтрация 
yield - допуск, выработка
shackles - кандалы, оковы 
heel - остаток, крен 
steering - рулевое управлени, бычок 
measles - корь 
faucets - смесители, краны 
strain - штамм, род, порода, напряжение 
virulence - ядовитость, злоба 
mumps - свинка 
plummet- стремительно падать, падать в цене 
bunnies- кролики
streetcar- трамвай 
*contraction* - сокращение, сужение 
traction - тяга, сила сцепление 
depreciate - обесцениваться 
upward - вверх every
second of the day - каждый второй день 
depreciation - амортизация
concave - вогнутый 
diminishing - уменьшающийся, убывающий 
returns - дохожность 
mortgage - залог 
conjecture - предположение 
sloppy - небрежный, грязный 
undully - чрезмерно 
starker - удручающий 
gulf -vводоворот, пропость 
genuinely - искренне 
*squint* - искоса, щуриться
upper-bound- верхний предел 
confections - кондитерские изделия 
shovel - лопата, экскаватор, ковш 
crumb - крошка 
tray - поддон, лоток 
pump - качалка 
teeter - кочели 
totter - качаться 
trait - орган 
gear - передача 
churning - перемешивание 
solvent - платежеспособный, состоятельный 
brink - край 
turnout - явка 
appeal - прозьба, призыв
abiding - неизменный 
slack - послабление 
grace period - льготный период 
impinge - сталкиаться, нарушать 
backlog - отставание, заказы, невыполненная работа 
predisposing - предрасположенность 
factor - множитель, показатель, момент 
admission - признание, прием, допуск
measly - жалкий 
piggyback - комбинирование
ingenuity - исскусство, изобретательность 
endorsement - передаточная надпись, подтверждение
amid - среди, посреди 
deli - гастроном 
influx - приток 
brood - выводок
consistency - согласованность 
terror - ужас 
piety - благочестие
contemplate - созерцать, размышлять, обдумывать, выдумывать 
odd - непарный, нечетный, чудной 
secular - светский 
heron - цапля 
plausible - правдоподобный 
claim - утверждать, претендовать 
entitled - иметь право 
genuine - подлинный 
cupboard - буфет 
conflation - слияние
*bowing* - поклон 
jealousy - ревниый 
awed - благоговеть 
sway - власть, влияние, качаться, колебаться 
contingency - непридвиденные обстоятельства 
capriciousness - капризность 
anticipate - предвидеть, ожидать 
*decent* - приличный, пристойный, порядочный, сромный take 
off - уменьшаться 
streak - полоса 
regression - возвращение 
free throw - штрафной бросок 
rinsing - полоскание 
delude - самообманывать
commitment - обязанность, вовлечение 
receivership - конкурсное управление, процедура банкротства 
supple - гибкий, эластичный 
efferent - выносящий, центробежный 
afferent - центростремительный, 
anticipate - предвидеть 
unimpeded - беспрепятственно 
shock - толчок 
constellation - созвездие 
gunning - обстрел 
even - четный, ровный
adjudicating - рассмотрении 
defect - отступиться 
treadmill - беговая дорожка 
hoarding - накопление 
pool - бассейн, фонд 
kin - родственный
selfless - бескорысный, самоотверженный 
better of - лучшее из 
cod - треска
spawning - нерест 
stock - масса, капитал 
sod - дерн 
graze - пасти
brand - марка, клеймо, тавро 
affiliation - присоединение, принадлежность 
service charge - плата за обслуживание 
timecard - табель, ведомость учета рабочего времени 
indulgence - снисхождение
forth - вперед 
slack - слабый, вялый 
put forth - пускать, пускатья
floppy - висящий, небрежный, болтающийся 
clay - глиняный 
incentive - стимул, побуждение 
lease - аренда, 
frenzy - безумие, неистовство
thrill - трепет, возбуждение 
ratcheting - прерывистое движение 
shade - оттенять, незначительное отличие 
surplus - избыток, излишек 
pivot - стержень, точка опоры, точка вращения 
embellishment - украшения 
remedy - средсво, мера, лекарство 
marginal - предельный, маргинальный, краевой 
pertinent - уместны, подходящий 
fidelity - точность, верность
whooping - судрожный, выкрикичающий 
abysmal - ужасный, бездонный 
merit - заслуга, достоинство, качество 
reconcile - согласовывать 
exacerbates - усугубляет 
fitness - годоность, пригодность, приспособленность
cardinal - главный rub - соприкосновение, трение 
adjudicate - судить
lettuce - салат-латук 
bun - булочка, плюшка 
mayo - майонез bearings -
направление, ориентация 
poulty - домашняя птица 
susceptible - восприимчевый, чуствительный 
vantage - приимущество
adversary - противник, враг, неприятель 
envy - зависть 
proliferation - распространение 
regurgitate - извергать 
salient - заметный
ramnification - ветвление 
martial - боевой, военный 
efficienty -продуктивность 
contentedness - удоволетворенность 
сontented - довольный, удоволетворенный 
contend - конкуренция 
incident - падающий
cardinality - мощность 
ache - ныть 
scum - жульничество 
purloined - отобранный 
obscenity - непристойность
vaporization - испарение
repertory - склад, хранилище
fiat - указ
empowerment - расширения прав и возмжностей
twerp - хам
turtleneck - водолазка
gob - плевок
pitch - шаг
quandary - затруднительное положение
clamp - зажим
compassionate - сострадательный
uncanny - жуткий, сверхестественный
seam - шов
exсruciatingly - мучительно
filings - подача, формы документов, регистрация и хранения документов в определенном виде
vigilance - бдительность, зоркость
due diligence - экспертиза, должная заботливость
revending - перепродажа
postage - почтовые расходы
hike - поход, рост
inflates - раздуает
sheer - ясный, чистый
wonker - зубрила
interrogate - допрашивать
reeks - вонь
overlay - налаживать, покрывало
obesity - ожирение
carrieth - уносило
feeleth - чувствовал
inclination - склонности
boast - хвастаться
inquisitiveness - любознательность
vitrolic - купоросный
setback - неудача
congestion - перегрузка, пробки
fleece - шерсть
grievance - жалоба
detente - разрядка
vapid - бессодержательный, скучный
drowsiness - дремота, вялость, сонливость
replenish - пополнять
deliquent - правонарушитель
carve - разделывать, дробить
ballot - голосование
auspices - покровительство
hideouse - отвратительный
chuckle - хихикать
astute - проницательный
wrigle out of - выпутаться
dismal - мрачный
attorney - адвокат
descretionary - на своё усмотрение
sediment - осадки
underpinning -  лежащие в основе
decrees - указы
friction - трение, разногласия
tasting - дегустация, проба
sentiment - настроение
amend - вносить поправки
mournful - скорбный
jay - сойка, болтун
concealed - скрытый
larva- личинка
allotment - выделение
incumbent - занимающий пост
rapture - восторг, экстаз
chastised - наказанный
tamer - дресировщик
layoff - уврольнение