idem - the same
potens - capable
im - not
commutativus - changing
association - connection
distibutivus - распределительный
absorptio - swallowing,вбирание
parere - to give birth, to produce, to prepare
reperire - to find
repertorium - list
cum hoc ergo propter hoc - with this, therefore because of this
cum - with
hoc - this
ergo - therefore
propter - because
civilis - гражданский, государственный
processus - течение, ход, продвижение
impersonalis - without namin a person
terme - баня
ad hoc - for this
noster - наш
facere - делать
unus - uni, one
sociare - united, joined
ad - near, at
impedimentum - тяжелый груз армии
sanctus - святой
lux - свет
fec - нести
est - есть
id - то